dim 18 14
pos 2 13
robo 2

**************** *
*     ****** *** * 
* *** ****** *** *
* *** ****** *** *
*     ******     *
* ********** *****
* ********** *****
* ********** *****
*               **
****** ******** **
****** ******** **
****** ******** **
*            ** **
******************

